"filename", "language", "TypeScript JSX", "TypeScript", "comment", "blank", "total"
"c:\Users\DELL\OneDrive\Documents\Next Js Projects\x_and_o\tictactoe\app\types\types.ts", "TypeScript", 0, 14, 0, 2, 16
"c:\Users\DELL\OneDrive\Documents\Next Js Projects\x_and_o\tictactoe\app\utils\groupByTime.ts", "TypeScript", 0, 45, 13, 9, 67
"c:\Users\DELL\OneDrive\Documents\Next Js Projects\x_and_o\tictactoe\components\Profile\EditProfilePicture.tsx", "TypeScript JSX", -4, 0, 0, -1, -5
"c:\Users\DELL\OneDrive\Documents\Next Js Projects\x_and_o\tictactoe\components\Profile\NotificationItem.tsx", "TypeScript JSX", -1, 0, 0, 3, 2
"c:\Users\DELL\OneDrive\Documents\Next Js Projects\x_and_o\tictactoe\components\Profile\ProfileHeader.tsx", "TypeScript JSX", 4, 0, 0, 0, 4
"c:\Users\DELL\OneDrive\Documents\Next Js Projects\x_and_o\tictactoe\components\allPlayers\AllPlayers.tsx", "TypeScript JSX", -3, 0, 2, -4, -5
"c:\Users\DELL\OneDrive\Documents\Next Js Projects\x_and_o\tictactoe\components\funcs\HandleAuth.ts", "TypeScript", 0, 4, 0, 3, 7
"c:\Users\DELL\OneDrive\Documents\Next Js Projects\x_and_o\tictactoe\components\gameMenu\GameMenu.tsx", "TypeScript JSX", 0, 0, 0, 1, 1
"c:\Users\DELL\OneDrive\Documents\Next Js Projects\x_and_o\tictactoe\components\globalChat\GlobalChat.tsx", "TypeScript JSX", 274, 0, -15, 21, 280
"c:\Users\DELL\OneDrive\Documents\Next Js Projects\x_and_o\tictactoe\components\globalChat\GlobalUserChatField.tsx", "TypeScript JSX", 99, 0, 5, 2, 106
"c:\Users\DELL\OneDrive\Documents\Next Js Projects\x_and_o\tictactoe\components\homepage\home\HomeHeader.tsx", "TypeScript JSX", 29, 0, -7, 1, 23
"c:\Users\DELL\OneDrive\Documents\Next Js Projects\x_and_o\tictactoe\components\homepage\home\Homepage.tsx", "TypeScript JSX", 3, 0, 0, 1, 4
"c:\Users\DELL\OneDrive\Documents\Next Js Projects\x_and_o\tictactoe\components\info\InfoMenu.tsx", "TypeScript JSX", 11, 0, 0, 0, 11
"c:\Users\DELL\OneDrive\Documents\Next Js Projects\x_and_o\tictactoe\components\nav\Nav.tsx", "TypeScript JSX", 17, 0, 0, 1, 18
"c:\Users\DELL\OneDrive\Documents\Next Js Projects\x_and_o\tictactoe\components\signup\SignUp.tsx", "TypeScript JSX", -1, 0, -1, -1, -3
"Total", "-", 428, 63, -3, 38, 526